WE textur/uchi4.png

SO textur/uchi1.png
NO textur/uchi2.png

EA textur/uchi3.png


F 220,100,1
C 225,30,0


        1111111111111111111111111
        1000000000000000000000011
        100000000000000S000000011
        1000000000000000000000011
111111111111111111100111111111111
100000000000000001001000000001111
100000000000000000000000000001
100000000000000000000000000001
100000000000000000000000000001
100000000000000000000000000001
100000000000000000000000000001
100000000000000000000000000001
101111111111111111111111111111
111111111111111111111111111111